32 24
1  1  1  1  1  1  1  1  1  1  1  1  1  1  1  1  1  1  1  1  1  1  1  1  1  1  1  1  1  1  1  1 
1  5  0  5  0 12 0  6  0  6  0  4  0  4  0 12 0  4  0  4  0  6  0  6  0 12 0  3  0  3  0  1 
1  5  0  5  0  0  0  6  0  6  0  4  0  4  0  0  0  4  0  4  0  6  0  6  0  0  0  3  0  3  0  1 
1  5  0  5  0  9  0  6  0  6  0  4  0  4  0  4  0  4  0  4  0  6  0  6  0  9  0  3  0  3  0  1 
1  5  0  5  0  9  0  6  0  6  0  4  0  4  0  4  0  4  0  4  0  6  0  6  0  9  0  3  0  3  0  1 
1  5  0  5  0  9  0  7  0  7  0  7  0  7  0  7  0  7  0  7  0  7  0  7  0  9  0  3  0  3  0  1 
1  5  0  5  0 10 0  7  0  7  0  7  0  7  0  7  0  7  0  7  0  7  0  7  0 10 0  3  0 11 0  1  
1  2  0  5  0  7  0  7  0  7  0  7  0  7  0  7  0  7  0  7  0  7  0  7  0  7  0  3  0  2  0  1  
1  2  0  2  0  8  0  8  0  8  0  8  0  8  0 10 0  8  0  8  0  8  0  8  0  8  0  2  0  2  0  1 
1  2  0  2  0  2  0  8  0  8  0  8  0  8  0 10 0  8  0  8  0  8  0  8  0  2  0  2  0  2  0  1 
1  2  0  2  0  2  0  2  0  8  0  8  0  8  0  8  0  8  0  8  0  8  0  2  0  2  0  2  0  2  0  1 
1  0  0  0  0  0  0  0  0  0  0  0  0  0  0  0  0  0  0  0  0  0  0  0  0  0  0  0  0  0  0  1  
1  0  0  0  0  0  0  0  0  0  0  0  0  0  0  0  0  0  0  0  0  0  0  0  0  0  0  0  0  0  0  1  
1  0  0  0  0  0  0  0  0  0  0  0  0  0  0  0  0  0  0  0  0  0  0  0  0  0  0  0  0  0  0  1  
1  0  0  0  0  0  0  0  0  0  0  0  0  0  0  0  0  0  0  0  0  0  0  0  0  0  0  0  0  0  0  1 
1  0  0  0  0  0  0  0  0  0  0  0  0  0  0  0  0  0  0  0  0  0  0  0  0  0  0  0  0  0  0  1 
1  0  0  0  0  0  0  0  0  0  0  0  0  0  0  0  0  0  0  0  0  0  0  0  0  0  0  0  0  0  0  1 
1  0  0  0  0  0  0  0  0  0  0  0  0  0  0  0  0  0  0  0  0  0  0  0  0  0  0  0  0  0  0  1 
1  0  0  0  0  0  0  0  0  0  0  0  0  0  0  0  0  0  0  0  0  0  0  0  0  0  0  0  0  0  0  1  
1  0  0  0  0  0  0  0  0  0  0  0  0  0  0  0  0  0  0  0  0  0  0  0  0  0  0  0  0  0  0  1  
1  0  0  0  0  0  0  0  0  0  0  0  0  0  0  0  0  0  0  0  0  0  0  0  0  0  0  0  0  0  0  1
1  0  0  0  0  0  0  0  0  0  0  0  0  0  0  0  0  0  0  0  0  0  0  0  0  0  0  0  0  0  0  1 
1  0  0  0  0  0  0  0  0  0  0  0  0  0  0  0  0  0  0  0  0  0  0  0  0  0  0  0  0  0  0  1  
1  0  0  0  0  0  0  0  0  0  0  0  0  0  0  0  0  0  0  0  0  0  0  0  0  0  0  0  0  0  0  1  