32 24
1  1  1  1  1  1  1  1  1  1  1  1  1  1  1  1  1  1  1  1  1  1  1  1  1  1  1  1  1  1  1  1 
1  2  0  2  0 11 0  3  0  9  0  9  0  9  0 12 0  9  0  9  0  9  0  3  0  3  0  2  0  2  0  1 
1  2  0  2  0  3  0  3  0  3  0  3  0  9  0  0  0  9  0  3  0  3  0  3  0  3  0  2  0  2  0  1 
1  2  0  2  0  3  0  3  0  3  0  3  0  9  0  9  0  9  0  3  0  3  0  3  0  3  0  2  0  2  0  1 
1  2  0  2  0  3  0  3  0  0  0  3  0  3  0  9  0  3  0  3  0  0  0  3  0  3  0  2  0  2  0  1 
1 10 0 10 0  3  0  3  0  0  0  3  0  3 0 10 0  3  0  3  0  0  0  3  0  3  0 10 0 10 0  1 
1  5  0  6  0  3  0  3  0  0  0  0  0  3  0  3  0  3  0  0  0  0  0  3  0  3  0  6  0  8  0  1 
1  5  0  6  0  3  0  3  0  0  0  0  0  3  0  3  0  3  0  0  0  0  0  3  0  3  0  6  0  8  0  1 
1  5  0  6  0  3  0  3  0  0  0  0  0  0  0  0  0  0  0  0  0  0  0  3  0  3  0  6  0  8  0  1  
1  0  0  0  0  0  0  0  0  0  0  0  0  0  0  0  0  0  0  0  0  0  0  0  0  0  0  0  0  0  0  1  
1  0  0  0  0  0  0  0  0  0  0  0  0  0  0  0  0  0  0  0  0  0  0  0  0  0  0  0  0  0  0  1 
1  0  0  0  0  0  0  0  0  0  0  0  0  0  0  0  0  0  0  0  0  0  0  0  0  0  0  0  0  0  0  1 
1  0  0  0  0  0  0  0  0  0  0  0  0  0  0  0  0  0  0  0  0  0  0  0  0  0  0  0  0  0  0  1 
1  0  0  0  0  0  0  0  0  0  0  0  0  0  0  0  0  0  0  0  0  0  0  0  0  0  0  0  0  0  0  1  
1  0  0  0  0  0  0  0  0  0  0  0  0  0  0  0  0  0  0  0  0  0  0  0  0  0  0  0  0  0  0  1  
1  0  0  0  0  0  0  0  0  0  0  0  0  0  0  0  0  0  0  0  0  0  0  0  0  0  0  0  0  0  0  1  
1  0  0  0  0  0  0  0  0  0  0  0  0  0  0  0  0  0  0  0  0  0  0  0  0  0  0  0  0  0  0  1 
1  0  0  0  0  0  0  0  0  0  0  0  0  0  0  0  0  0  0  0  0  0  0  0  0  0  0  0  0  0  0  1 
1  0  0  0  0  0  0  0  0  0  0  0  0  0  0  0  0  0  0  0  0  0  0  0  0  0  0  0  0  0  0  1 
1  0  0  0  0  0  0  0  0  0  0  0  0  0  0  0  0  0  0  0  0  0  0  0  0  0  0  0  0  0  0  1 
1  0  0  0  0  0  0  0  0  0  0  0  0  0  0  0  0  0  0  0  0  0  0  0  0  0  0  0  0  0  0  1  
1  0  0  0  0  0  0  0  0  0  0  0  0  0  0  0  0  0  0  0  0  0  0  0  0  0  0  0  0  0  0  1  
1  0  0  0  0  0  0  0  0  0  0  0  0  0  0  0  0  0  0  0  0  0  0  0  0  0  0  0  0  0  0  1  
1  0  0  0  0  0  0  0  0  0  0  0  0  0  0  0  0  0  0  0  0  0  0  0  0  0  0  0  0  0  0  1 