32 24
1  1  1  1  1  1  1  1  1  1  1  1  1  1  1  1  1  1  1  1  1  1  1  1  1  1  1  1  1  1  1  1 
1  3  0  4  0  2  0  5  0 12 0  7  0  2  0  3  0 2  0  7  0 12 0  5  0  2  0  4  0  3  0  1 
1  3  0  4  0  2  0  5  0  0  0  7  0  2  0 10 0  2  0  7  0  0  0  5  0  2  0  4  0  3  0  1 
1  3  0  4  0  2  0  5  0  6  0  7  0  7  0  3  0  7  0  7  0  6  0  5  0  2  0  4  0  3  0  1 
1  3  0  4  0 10 0  5  0  6  0  7  0  7  0  8  0  7  0  7  0  6  0  5  0 10 0  4  0  3  0  1 
1  3  0  4  0  4  0  5  0  6  0  7  0  7  0  8  0  7  0  7  0  6  0  5  0  4  0  4  0  3  0  1 
1  3  0  4  0  4  0  5  0  6  0  7  0  7  0  8  0  7  0  7  0  6  0  5  0  4  0  4  0  3  0  1 
1  3  0  4  0  4  0  5  0  6  0  7  0  7  0  8  0  7  0  7  0  6  0  5  0  4  0  4  0  3  0  1 
1  3  0  4  0  4  0  5  0  6  0  7  0  7  0  8  0  7  0  7  0  6  0  5  0  4  0  4  0  3  0  1 
1 11 0  4  0  4  0  5  0  6  0  7  0  7  0  8  0  7  0  7  0  6  0  5  0  4  0  4  0  3  0  1 
1  2  0  2  0  2  0 10 0  0  0  0  0  0  0  0  0  0  0  0  0  0  0 10 0  2  0  2  0  2  0  1 
1  0  0  0  0  0  0  0  0  0  0  0  0  0  0  0  0  0  0  0  0  0  0  0  0  0  0  0  0  0  0  1 
1  0  0  0  0  0  0  0  0  0  0  0  0  0  0  0  0  0  0  0  0  0  0  0  0  0  0  0  0  0  0  1 
1  0  0  0  0  0  0  0  0  0  0  0  0  0  0  0  0  0  0  0  0  0  0  0  0  0  0  0  0  0  0  1 
1  0  0  0  0  0  0  0  0  0  0  0  0  0  0  0  0  0  0  0  0  0  0  0  0  0  0  0  0  0  0  1 
1  0  0  0  0  0  0  0  0  0  0  0  0  0  0  0  0  0  0  0  0  0  0  0  0  0  0  0  0  0  0  1  
1  0  0  0  0  0  0  0  0  0  0  0  0  0  0  0  0  0  0  0  0  0  0  0  0  0  0  0  0  0  0  1  
1  0  0  0  0  0  0  0  0  0  0  0  0  0  0  0  0  0  0  0  0  0  0  0  0  0  0  0  0  0  0  1 
1  0  0  0  0  0  0  0  0  0  0  0  0  0  0  0  0  0  0  0  0  0  0  0  0  0  0  0  0  0  0  1 
1  0  0  0  0  0  0  0  0  0  0  0  0  0  0  0  0  0  0  0  0  0  0  0  0  0  0  0  0  0  0  1 
1  0  0  0  0  0  0  0  0  0  0  0  0  0  0  0  0  0  0  0  0  0  0  0  0  0  0  0  0  0  0  1  
1  0  0  0  0  0  0  0  0  0  0  0  0  0  0  0  0  0  0  0  0  0  0  0  0  0  0  0  0  0  0  1  
1  0  0  0  0  0  0  0  0  0  0  0  0  0  0  0  0  0  0  0  0  0  0  0  0  0  0  0  0  0  0  1  
1  0  0  0  0  0  0  0  0  0  0  0  0  0  0  0  0  0  0  0  0  0  0  0  0  0  0  0  0  0  0  1 